........
........
.X......
###..G.G
.....GGG
.....G.G
G.G..###
.G......
G.G.....
###..GGG
.....GGG
.....G.G
.....###
........
1.......
########
