....................
....................
..........X.........
.......######.......
..G..............G..
####..G.G.G.G....###
.......G.G.GCG......
......--------......
...--...........--..
....................
.G.G............P.G.
####................
....................
.1.............F..H.
####################
