....................
...G............X...
...--..G.......--...
....G.--........G...
...--..........--...
...H......G....G....
...--....--....--...
....G...........G...
...--........L.--...
...G........--.G....
...--..........--...
....G...........G...
...--..........--...
.1............F.....
99999999999999999999
